11111111111
11110000011
11000110111
00011110111
11111110111
11100010111
11101010001
11101010111
11101010111
11101000111
11101111111
00000000000
00200000000
22000000000
00000000000
00000020000
00000020000
00002000000
00000000000
00000000000
00000000000
00000000000